1111111111111111111
1110011111111001111
1111001111111011111
1111000001000011111
1111010100010C01111
1111C10111100101111
1110010000000101111
1110100011010101111
100C001100010101111
101110000PE000000C1
1011101100011011011
1001001C01011011011
1101011011000011011
110100001110011C011
1101110C00010010111
1100001111111000111
1111000011111000111
111C011011110010111
1101011000C00110011
1111111111111111111